1111111111111
10000000M00C1
1000000000001
1P0000E000001
1111111111111