1111111111111
10010000000C1
10M0011111001
1P0011E0000M1
1111111111111