1111111111111111111111111111111111
1E000000000M000C00000C000000M00001
1010010100100000101001000000010101
1010010010101010001001000000010101
1P000M000C00C00000000000000M0000C1
1111111111111111111111111111111111