1111111111111
10000000000C1
1011111111101
1P0000E00M001
1111111111111