1111111111111
100000M0000C1
1011111111101
1P0000E000001
1111111111111